┌   ┬---┬---┬---┬---┬---┬---┬---┬---┬---┬---┬---┬---┬---┬---┬---┐
│           │           │                   │                   │
├---┼---┼   ┼---┼   ┼   ┼   ┼---┼---┼---┼   ┼   ┼---┼---┼---┼   ┤
│       │       │   │       │           │       │               │
├   ┼---┼---┼   ┼   ┼---┼---┼   ┼---┼   ┼---┼---┼   ┼---┼---┼---┤
│   │       │       │               │       │   │   │           │
├   ┼   ┼   ┼---┼---┼   ┼---┼---┼   ┼---┼   ┼   ┼   ┼   ┼---┼---┤
│       │               │       │   │   │       │   │           │
├   ┼---┼---┼---┼---┼---┼   ┼---┼   ┼   ┼---┼   ┼   ┼---┼   ┼   ┤
│           │               │       │       │   │       │   │   │
├---┼---┼   ┼---┼   ┼---┼   ┼   ┼---┼---┼   ┼   ┼---┼   ┼---┼   ┤
│       │       │       │   │   │           │   │   │   │       │
├   ┼   ┼---┼   ┼   ┼   ┼   ┼   ┼---┼   ┼---┼   ┼   ┼   ┼   ┼---┤
│   │       │   │   │   │   │       │               │   │       │
├   ┼---┼   ┼   ┼---┼   ┼   ┼---┼   ┼   ┼---┼---┼---┼   ┼---┼   ┤
│   │       │       │   │   │   │   │           │       │       │
├   ┼---┼   ┼---┼   ┼   ┼   ┼   ┼   ┼---┼---┼   ┼   ┼---┼   ┼   ┤
│       │       │       │   │   │           │   │   │       │   │
├   ┼   ┼---┼---┼---┼---┼   ┼   ┼---┼---┼   ┼---┼   ┼   ┼---┼   ┤
│   │   │               │       │       │           │       │   │
├---┼   ┼   ┼---┼   ┼   ┼---┼   ┼   ┼---┼---┼---┼---┼   ┼   ┼   ┤
│       │       │   │       │   │                   │   │   │   │
├   ┼---┼---┼   ┼   ┼---┼   ┼   ┼---┼   ┼---┼   ┼---┼   ┼   ┼---┤
│               │   │   │   │       │       │           │       │
├   ┼---┼---┼---┼   ┼   ┼   ┼---┼   ┼---┼---┼   ┼---┼---┼---┼   ┤
│               │   │   │   │       │       │   │               │
├---┼   ┼---┼---┼   ┼   ┼   ┼   ┼---┼   ┼   ┼---┼   ┼---┼---┼   ┤
│   │   │           │       │       │   │           │       │   │
├   ┼   ┼   ┼---┼---┼---┼---┼---┼   ┼   ┼---┼---┼---┼   ┼   ┼   ┤
│       │               │       │   │       │   │       │   │   │
├   ┼---┼---┼---┼---┼   ┼   ┼   ┼   ┼---┼   ┼   ┼   ┼   ┼---┼   ┤
│                   │       │               │       │           │
└---┴---┴---┴---┴---┴---┴---┴---┴---┴---┴---┴---┴---┴---┴---┴   ┘
