┌   ┬---┬---┬---┬---┬---┬---┬---┬---┬---┬---┬---┬---┬---┬---┬---┐
│           │           │                       │       │       │
├---┼---┼   ┼---┼   ┼   ┼   ┼   ┼---┼---┼---┼   ┼   ┼   ┼   ┼   ┤
│       │   │       │   │   │           │   │   │   │       │   │
├   ┼---┼   ┼   ┼---┼   ┼   ┼---┼---┼   ┼   ┼   ┼---┼   ┼---┼   ┤
│   │       │   │       │   │       │   │   │       │       │   │
├   ┼   ┼---┼   ┼---┼   ┼   ┼---┼   ┼   ┼   ┼---┼   ┼   ┼---┼   ┤
│       │           │   │           │   │       │   │   │       │
├   ┼---┼---┼   ┼   ┼   ┼---┼---┼   ┼   ┼---┼   ┼   ┼---┼   ┼   ┤
│   │       │   │   │   │           │   │       │       │   │   │
├   ┼   ┼   ┼---┼   ┼---┼   ┼---┼---┼   ┼   ┼   ┼---┼   ┼   ┼   ┤
│       │   │       │       │       │   │   │   │       │   │   │
├---┼---┼   ┼   ┼   ┼   ┼---┼   ┼   ┼   ┼   ┼---┼   ┼---┼   ┼   ┤
│       │   │   │   │   │   │   │       │       │   │       │   │
├   ┼   ┼   ┼   ┼---┼   ┼   ┼   ┼---┼---┼   ┼   ┼   ┼   ┼---┼   ┤
│   │       │   │           │   │           │       │   │       │
├   ┼---┼---┼   ┼   ┼---┼---┼   ┼   ┼---┼---┼---┼---┼   ┼   ┼---┤
│       │           │       │   │       │               │   │   │
├---┼   ┼---┼---┼---┼   ┼   ┼   ┼---┼   ┼---┼---┼   ┼   ┼   ┼   ┤
│       │               │       │   │           │   │   │   │   │
├   ┼---┼   ┼---┼---┼---┼---┼---┼   ┼---┼---┼   ┼---┼   ┼   ┼   ┤
│   │       │       │                       │           │   │   │
├   ┼   ┼   ┼   ┼---┼   ┼---┼---┼---┼   ┼   ┼---┼---┼---┼   ┼   ┤
│   │   │   │   │       │       │       │   │           │       │
├   ┼---┼   ┼   ┼   ┼---┼---┼   ┼   ┼---┼   ┼---┼---┼   ┼---┼   ┤
│   │       │       │       │   │   │       │           │       │
├   ┼   ┼---┼---┼   ┼   ┼   ┼   ┼   ┼   ┼---┼   ┼---┼   ┼   ┼---┤
│   │           │       │       │   │           │       │   │   │
├   ┼---┼   ┼   ┼---┼   ┼---┼---┼   ┼   ┼---┼---┼   ┼---┼   ┼   ┤
│       │   │   │       │           │   │       │       │   │   │
├---┼   ┼---┼   ┼   ┼---┼   ┼---┼---┼---┼   ┼   ┼---┼---┼   ┼   ┤
│               │       │                   │                   │
└---┴---┴---┴---┴---┴---┴---┴---┴---┴---┴---┴---┴---┴---┴---┴   ┘
