┌   ┬---┬---┬---┬---┬---┬---┬---┬---┬---┬---┬---┬---┬---┬---┬---┐
│   │       │                   │           │                   │
├   ┼   ┼   ┼   ┼---┼---┼---┼   ┼---┼   ┼   ┼---┼---┼---┼---┼   ┤
│       │   │           │       │       │                       │
├---┼---┼   ┼---┼   ┼   ┼   ┼---┼   ┼---┼---┼---┼---┼---┼---┼   ┤
│       │       │   │   │           │               │           │
├   ┼---┼---┼   ┼   ┼   ┼---┼---┼---┼   ┼---┼   ┼   ┼   ┼---┼---┤
│           │   │   │           │   │   │   │   │   │   │       │
├---┼---┼   ┼   ┼   ┼---┼---┼   ┼   ┼   ┼   ┼   ┼---┼   ┼   ┼   ┤
│           │   │       │   │   │           │   │       │   │   │
├   ┼---┼---┼   ┼---┼   ┼   ┼   ┼---┼---┼---┼   ┼   ┼---┼---┼   ┤
│           │   │           │   │           │   │   │           │
├   ┼---┼   ┼   ┼   ┼---┼---┼   ┼   ┼---┼   ┼   ┼   ┼   ┼   ┼   ┤
│   │   │       │       │       │   │   │       │   │   │   │   │
├   ┼   ┼---┼---┼---┼---┼   ┼---┼   ┼   ┼---┼   ┼   ┼---┼   ┼   ┤
│                   │       │       │       │   │   │       │   │
├---┼---┼---┼---┼   ┼   ┼---┼   ┼---┼   ┼   ┼   ┼   ┼   ┼---┼   ┤
│           │   │   │       │       │   │   │   │   │       │   │
├   ┼---┼   ┼   ┼   ┼   ┼   ┼---┼   ┼   ┼---┼   ┼   ┼   ┼   ┼   ┤
│   │       │   │   │   │       │   │           │   │   │   │   │
├   ┼   ┼---┼   ┼   ┼---┼---┼   ┼   ┼---┼---┼---┼   ┼   ┼   ┼   ┤
│   │   │       │               │       │           │   │   │   │
├   ┼   ┼---┼   ┼---┼---┼---┼---┼---┼   ┼   ┼---┼---┼   ┼   ┼---┤
│   │                               │   │       │   │   │       │
├   ┼---┼---┼---┼---┼---┼---┼---┼   ┼   ┼---┼   ┼   ┼   ┼---┼   ┤
│           │               │           │       │       │       │
├   ┼---┼   ┼   ┼---┼---┼   ┼   ┼---┼---┼   ┼---┼---┼---┼   ┼---┤
│       │   │   │       │   │   │       │               │       │
├   ┼---┼   ┼   ┼   ┼   ┼   ┼---┼   ┼   ┼---┼---┼---┼   ┼   ┼   ┤
│   │       │   │   │   │       │   │               │   │   │   │
├   ┼   ┼---┼   ┼   ┼   ┼---┼   ┼   ┼---┼---┼   ┼---┼   ┼---┼   ┤
│   │               │       │               │                   │
└---┴---┴---┴---┴---┴---┴---┴---┴---┴---┴---┴---┴---┴---┴---┴   ┘
